111111111111111111111111111111111e
100000000000000000000000000000001e
100000000000000000000000000000001e
100000000000000000000000000000001e
100000000000000000000000000000001e
100000000000000000000000000000001e
100010000000000000000000000000001e
100010005000050000000000000000001e
100010001100011000000111111100001e
100010000000000000000000000000001e
100010000000000000000000000000001e
100010000000000000000000000000001e
100010000000000000000110000111111e
100010000200000000005110000111111e
103010000000000000011111040111111e
111111111111111111111111111111111ff
