111111111111111111111111111111111e
100000000000000000000000000000001e
100002000000000000000000000000001e
100000000000050000000000004000301e
111111111111111111100110001111111e
000000000000000000100000001000000e
000000000000000000100000011000000e
000000000000000000150011111000000e
000000000000000000111111111000000e
000000000000000000111111111000000ff
